0#######
#      #
#      #
#   p  #
#   b  #
#   +  #
#      #
########

1#######
#      #
#   +  #
#   p  #
#   b  #
#      #
#      #
########

########
# b+p ##
# ##  ##
#   b ##
#   +###
#  #####
########
########

########
#  +p ##
# #+# ##
#   b ##
#+bb ###
#  #####
########
########